"ADJ"	"ADJ"
"ATTACK"	"ATTACK"
"BASIC_MAT"	"MATERIAL"
"BODY"	"BODY"
"BODY_APPEARANCE_MODIFIER"	"BODY_APPEARANCE_MODIFIER"
"BP"	"BP"
"BP_APPEARANCE_MODIFIER"	"BODY_APPEARANCE_MODIFIER"
"BODY_DETAIL_PLAN"	"BODY_DETAIL_PLAN"
"BUILDING_FURNACE"	"BUILDING_WORKSHOP"
"BUILDING_WORKSHOP"	"BUILDING_WORKSHOP"
"BUILD_ITEM"	"BUILD_ITEM"
"CAN_DO_INTERACTION"	"CAN_DO_INTERACTION"
"CASTE"	"CASTE"
"CE_BODY_TRANSFORMATION"	"CE_BODY_TRANSFORMATION"
"CE_CAN_DO_INTERACTION"	"CAN_DO_INTERACTION"
"CREATURE_GRAPHICS" "CREATURE_GRAPHICS"
"TILE_PAGE" "TILE_PAGE"
"COLOR"	"COLOR"
"COLOR_PATTERN"	"COLOR_PATTERN"
"CREATURE"	"CREATURE"
"CREATURE_VARIATION"	"CREATURE_VARIATION"
"CV_CONVERT_TAG"	"CV_CONVERT_TAG"
"ENTITY"	"ENTITY"
"EXTRA_BUTCHER_OBJECT"	"EXTRA_BUTCHER_OBJECT"
"GROWTH" "GROWTH"
"INORGANIC"	"INORGANIC"
"INTERACTION"	"INTERACTION"
"ITEM_AMMO"	"ITEM_AMMO"
"ITEM_ARMOR"	"ITEM_ARMOR"
"ITEM_FOOD"	"ITEM_FOOD"
"ITEM_GLOVES"	"ITEM_ARMOR"
"ITEM_HELM"	"ITEM_ARMOR"
"ITEM_INSTRUMENT"	"ITEM_INSTRUMENT"
"ITEM_PANTS"	"ITEM_ARMOR"
"ITEM_SHIELD"	"ITEM_ARMOR"
"ITEM_SHOES"	"ITEM_ARMOR"
"ITEM_SIEGEAMMO"	"ITEM_SIEGEAMMO"
"ITEM_TOOL"	"ITEM_TOOL"
"ITEM_TOY"	"ITEM_TOY"
"ITEM_TRAPCOMP"	"ITEM_TRAPCOMP"
"ITEM_WEAPON"	"ITEM_WEAPON"
"I_EFFECT"	"I_EFFECT"
"I_SOURCE"	"I_SOURCE"
"I_TARGET"	"I_TARGET"
"LAYS_EGGS"	"LAYS_EGGS"
"MATERIAL"	"MATERIAL"
"MATERIAL_TEMPLATE"	"MATERIAL"
"NOUN"	"NOUN"
"OBJECT"	"OBJECT"
"PLANT"	"PLANT"
"POSITION"	"POSITION"
"PREFIX"	"PREFIX"
"PRODUCT"	"PRODUCT"
"REACTION"	"REACTION"
"REAGENT"	"REAGENT"
"SELECT_CASTE"	"CASTE"
"SELECT_MATERIAL"	"MATERIAL"
"SELECT_TISSUE"	"TISSUE"
"SELECT_TISSUE_LAYER"	"TISSUE_LAYER"
"SET_BP_GROUP"	"SET_BP_GROUP"
"SET_TL_GROUP"	"TISSUE_LAYER"
"SHAPE"	"SHAPE"
"SYMBOL"	"SYMBOL"
"SYNDROME"	"SYNDROME"
"TISSUE"	"TISSUE"
"TISSUE_LAYER"	"TISSUE_LAYER"
"TISSUE_LAYER_APPEARANCE_MODIFIER""TISSUE_LAYER_APPEARANCE_MODIFIER"
"TISSUE_STYLE"	"TISSUE_STYLE"
"TISSUE_STYLE_UNIT"	"TISSUE_STYLE_UNIT"
"TISSUE_TEMPLATE"	"TISSUE"
"TL_COLOR_MODIFIER"	"TL_COLOR_MODIFIER"
"TRANSLATION"	"TRANSLATION"
"USE_MATERIAL"	"MATERIAL"
"USE_MATERIAL_TEMPLATE"	"MATERIAL"
"USE_TISSUE"	"TISSUE"
"USE_TISSUE_TEMPLATE"	"TISSUE"
"VERB"	"VERB"
"WEAPON"	"WEAPON"
"WORD"	"WORD"
